Hour,Gen1,Gen2,Gen3,Total_Generation,Unmet_Load
0,20,25,0,45,0
1,20,30,1,51,0
2,20,30,5,55,0
3,20,30,8,58,0
4,20,30,10,60,0
5,20,30,11,61,0
6,20,30,10,60,0
7,20,30,8,58,0
8,20,30,6,56,0
9,20,30,2,52,0
10,20,26,0,46,0
11,20,21,0,41,0
12,20,16,0,36,0
13,20,10,0,30,0
14,20,6,0,26,0
15,20,3,0,23,0
16,20,2,0,22,0
17,20,1,0,21,0
18,20,2,0,22,0
19,20,5,0,25,0
20,20,7,0,27,0
21,20,12,0,32,0
22,20,17,0,37,0
23,20,22,0,42,0
